Столица страны Австрия - Вена<br>
Столица страны Албания - Тирана<br>
Столица страны Андорра - Андорра-ла-Велья<br>
Столица страны Беларусь - Минск<br>
Столица страны Бельгия - Брюссель<br>
Столица страны Болгария - София<br>
Столица страны Босния и Герцеговина - Сараево<br>
Столица страны Ватикан - Ватикан<br>
Столица страны Великобритания - Лондон<br>
Столица страны Венгрия - Будапешт<br>
Столица страны Германия - Берлин<br>
Столица страны Греция - Афины<br>
Столица страны Дания - Копенгаген<br>
Столица страны Исландия - Рейкьявик<br>
Столица страны Испания - Мадрид<br>
Столица страны Италия - Рим<br>
Столица страны Латвия - Рига<br>
Столица страны Литва - Вильнюс<br>
Столица страны Лихтенштейн - Вадуц<br>
Столица страны Люксембург - Люксембург<br>
Столица страны Македония - Скопье<br>
Столица страны Мальта - Валлетта<br>
Столица страны Молдова - Кишинёв<br>
Столица страны Монако - Монако<br>
Столица страны Нидерланды - Амстердам<br>
Столица страны Норвегия - Осло<br>
Столица страны Польша - Варшава<br>
Столица страны Португалия - Лиссабон<br>
Столица страны Россия - Москва<br>
Столица страны Румыния - Бухарест<br>
Столица страны Сан-Марино - Сан-Марино<br>
Столица страны Сербия - Белград<br>
Столица страны Словакия - Братислава<br>
Столица страны Словения - Любляна<br>
Столица страны Украина - Киев<br>
Столица страны Финляндия - Хельсинки<br>
Столица страны Франция - Париж<br>
Столица страны Хорватия - Загреб<br>
Столица страны Черногория - Подгорица<br>
Столица страны Чехия - Прага<br>
Столица страны Швейцария - Берн<br>
Столица страны Швеция - Стокгольм<br>
Столица страны Эстония - Таллин<br>
Столица страны Ирландия - Дублин<br>
<p>Столица страны Азербайджан - Баку<br>
Столица страны Армения - Ереван<br>
Столица страны Афганистан - Кабул<br>
Столица страны Бангладеш - Дакка<br>
Столица страны Бахрейн - Манама<br>
Столица страны Бруней-Даруссалам - Бандар-Сери-Бегаван<br>
Столица страны Бутан - Тхимпху<br>
Столица страны Восточный Тимор - Дили<br>
Столица страны Вьетнам - Ханой<br>
Столица страны Грузия - Тбилиси<br>
Столица страны Израиль - Иерусалим<br>
Столица страны Индонезия - Джакарта<br>
Столица страны Иордания - Амман<br>
Столица страны Ирак - Багдад<br>
Столица страны Иран - Тегеран<br>
Столица страны Йемен - Сана<br>
Столица страны Казахстан - Астана<br>
Столица страны Камбоджа - Пномпень<br>
Столица страны Катар - Доха<br>
Столица страны Кипр - Никосия<br>
Столица страны Кыргызстан - Бишкек<br>
Столица страны Тайвань - Тайбэй<br>
Столица страны Северная Корея - Пхеньян<br>
Столица страны Китай - Пекин<br>
Столица страны Кувейт - Эль-Кувейт<br>
Столица страны Лаос - Вьентьян<br>
Столица страны Ливан - Бейрут<br>
Столица страны Малайзия - Куала-Лумпур<br>
Столица страны Мальдивы - Мале<br>
Столица страны Монголия - Улан-Батор<br>
Столица страны Мьянма - Нейпьидо<br>
Столица страны Непал - Катманду<br>
Столица страны ОАЭ - Абу-Даби<br>
Столица страны Оман - Маскат<br>
Столица страны Пакистан - Исламабад<br>
Столица страны Южная Корея - Сеул<br>
Столица страны Саудовская Аравия - Эр-Рияд<br>
Столица страны Сингапур - Сингапур<br>
Столица страны Сирия - Дамаск<br>
Столица страны Таджикистан - Душанбе<br>
Столица страны Таиланд - Бангкок<br>
Столица страны Туркменистан - Ашхабад<br>
Столица страны Турция - Анкара<br>
Столица страны Узбекистан - Ташкент<br>
Столица страны Филиппины - Манила<br>
Столица страны Шри-Ланка - Шри-Джаяварденепура-Котте<br>
Столица страны Япония - Токио<br>
Столица страны Индия - Дели (Нью-Дели)<br>
<p>Столица страны Алжир - Алжир<br>
Столица страны Ангола - Луанда<br>
Столица страны Демократическая республика Конго - Луанда<br>
Столица страны Бенин - Порто-Ново<br>
Столица страны Ботсвана - Габороне<br>
Столица страны Буркина-Фасо - Уагадугу<br>
Столица страны Бурунди - Бужумбура<br>
Столица страны Габон - Либревиль<br>
Столица страны Гамбия - Банжул<br>
Столица страны Гана - Аккра<br>
Столица страны Гвинея - Конакри<br>
Столица страны Папуа Новая Гвинея - Конакри<br>
Столица страны Гвинея-Бисау - Бисау<br>
Столица страны Демократическая Республика Конго - Киншаса<br>
Столица страны Джибути - Джибути<br>
Столица страны Египет - Каир<br>
Столица страны Сейшельские о-ва - Каир<br>
Столица страны Замбия - Лусака<br>
Столица страны Зимбабве - Хараре<br>
Столица страны Кабо-Верде - Прая<br>
Столица страны Камерун - Яунде<br>
Столица страны Кения - Найроби<br>
Столица страны Коморские острова - Морони<br>
Столица страны Конго - Морони<br>
Столица страны Кот д’Ивуар - Ямусукро<br>
Столица страны Кот дИвуар - Ямусукро<br>
Столица страны Лесото - Масеру<br>
Столица страны Либерия - Монровия<br>
Столица страны Маврикий - Порт-Луи<br>
Столица страны Мавритания - Нуакшот<br>
Столица страны Мадагаскар - Антананариву<br>
Столица страны Малави - Лилонгве<br>
Столица страны Мали - Бамако<br>
Столица страны Марокко - Рабат<br>
Столица страны Мозамбик - Мапуту<br>
Столица страны Намибия - Виндхук<br>
Столица страны Нигер - Ниамей<br>
Столица страны Нигерия - Абуджа<br>
Столица страны Республика Конго - Браззавиль<br>
Столица страны Руанда - Кигали<br>
Столица страны Сан-Томе и Принсипи - Сан-Томе<br>
Столица страны Западная Сахара - Тифарити<br>
Столица страны Свазиленд - Мбабане<br>
Столица страны Сейшельские Острова - Виктория<br>
Столица страны Сенегал - Дакар<br>
Столица страны Сомали - Могадишо<br>
Столица страны Судан - Хартум<br>
Столица страны Сьерра-Леоне - Фритаун<br>
Столица страны Танзания - Додома<br>
Столица страны Того - Ломе<br>
Столица страны Тунис - Тунис<br>
Столица страны Уганда - Кампала<br>
Столица страны Центральноафриканская Республика - Банги<br>
Столица страны Чад - Нджамена<br>
Столица страны Экваториальная Гвинея - Малабо<br>
Столица страны Эритрея - Асмэра<br>
Столица страны Эфиопия - Аддис-Абеба<br>
Столица страны ЮАР - Претория<br>
Столица страны Ливия - Триполи<h3>
<p>Столица страны Антигуа и Барбуда - Сент-Джонс<br>
Столица страны Аргентина - Буэнос-Айрес<br>
Столица страны Багамские острова - Нассау<br>
Столица страны Барбадос - Бриджтаун<br>
Столица страны Белиз - Бельмопан<br>
Столица страны Боливия - Сукре<br>
Столица страны Бразилия - Бразилиа<br>
Столица страны Венесуэла - Каракас<br>
Столица страны Гаити - Порт-о-Пренс<br>
Столица страны Гайана - Джорджтаун<br>
Столица страны Гватемала - Гватемала<br>
Столица страны Гондурас - Тегусигальпа<br>
Столица страны Гренада - Сент-Джорджес<br>
Столица страны Доминика - Розо<br>
Столица страны Доминиканская Республика - Санто-Доминго<br>
Столица страны Канада - Оттава<br>
Столица страны Колумбия - Богота<br>
Столица страны Коста-Рика - Сан-Хосе<br>
Столица страны Куба - Гавана<br>
Столица страны Мексика - Мехико<br>
Столица страны Никарагуа - Манагуа<br>
Столица страны Теркс и Кайкос - Манагуа<br>
Столица страны Панама - Панама<br>
Столица страны Парагвай - Асунсьон<br>
Столица страны Перу - Лима<br>
Столица страны Сальвадор - Сан-Сальвадор<br>
Столица страны Сент-Винсент и Гренадины - Кингстаун<br>
Столица страны Сент-Китс и Невис - Бастер<br>
Столица страны Сент-Люсия - Кастри<br>
Столица страны Суринам - Парамарибо<br>
Столица страны США - Вашингтон<br>
Столица страны Внешние малые острова США - Вашингтон<br>
Столица страны Пуэрто Рико - Вашингтон<br>
Столица страны Гренландия - Вашингтон<br>
Столица страны Тринидад и Тобаго - Порт-оф-Спейн<br>
Столица страны Уругвай - Монтевидео<br>
Столица страны Чили - Сантьяго<br>
Столица страны Эквадор - Кито<br>
Столица страны Ямайка - Кингстон<h3>
<p>Столица страны Австралия - Канберра<br>
Столица страны Вануату - Порт-Вила<br>
Столица страны Кирибати - Южная Тарава (Баирики)<br>
Столица страны Маршалловы Острова - Маджуро<br>
Столица страны Маршалловы острова - Маджуро<br>
Столица страны Микронезия - Паликир<br>
Столица страны Науру - Официальной столицы нет<br>
Столица страны Новая Зеландия - Веллингтон<br>
Столица страны Палау - Нгерулмуд<br>
Столица страны Папуа — Новая Гвинея - Порт-Морсби<br>
Столица страны Самоа - Апиа<br>
Столица страны Соломоновы Острова - Хониара<br>
Столица страны Соломоновы острова - Хониара<br>
Столица страны Тонга - Нукуалофа<br>
Столица страны Тувалу - Фунафути<br>
Столица страны Фиджи - Сува<br>
Столица страны Французская Полинезия - Сува<br>
Столица страны Новая Каледония - Сува<br>
Столица страны Острова Кука - Хониара<br>